#########X##########
#..................#
#..................#
#....G.............#
#....G.............#
#...GG.GG..........#
#...G.GGG..........#
#..GGG..G..........#
#.......G..G.......#
X......G.GGG.......X
#......GG..G.......#
#.....GGG.G........#
#.........G..GG....#
#........GGGGGG....#
#........GG..G.....#
#............G.....#
#..................#
#..................#
#..................#
#########X##########