#########X##########
#..................#
#..................#
#......*...........#
#......*...........#
#.....*...**.......#
#.....******.......#
#..........*.......#
#.........*........#
X........**........X
#........*****.....#
#............*.....#
#............*.....#
#..................#
#..................#
#..................#
#..................#
#..................#
#..................#
#########X##########