############X############
#.......................#
#.......................#
#.......................#
#...........******......#
#....********....**.....#
#....*......*....**.....#
#....*...........**.....#
#....**...**.**..*......#
#.....*.........**......#
#.....*.....*...*.......#
X.....****..*..**.......X
#...........*...........#
#...........*...........#
#.......................#
#...........*...........#
#...........*...........#
#...........*...........#
#...........*...........#
#.......................#
#.......................#
#.......................#
#.......................#
#.......................#
############X############
