############X############
#.......................#
#.......................#
#.......................#
#.....*********.........#
#............***........#
#...........***.........#
#..........***..........#
#.........**............#
#........**.............#
#.......**..............#
X......**...............X
#.....**................#
#.....*.................#
#....**.................#
#....*.............*....#
#....**............*....#
#.....**..........**....#
#......*************....#
#.......................#
#.......................#
#.......................#
#.......................#
#.......................#
############X############
